date,tested,negative,positive,isol_in,isol_out,quar_in,quar_out,new_cases
09/04/2020,327,300,27,27,0,35,0,27
09/11/2020,70,65,5,4,15,7,15,4
09/18/2020,68,61,7,7,3,18,12,7
09/25/2020,81,80,1,0,12,9,9,0
10/02/2020,77,65,12,12,3,12,20,12
10/09/2020,65,46,19,15,10,5,17,15
10/16/2020,72,57,15,9,17,15,8,9
10/23/2020,76,72,4,4,9,7,12,4
10/30/2020,66,60,6,6,3,22,5,6
11/06/2020,80,78,2,2,8,8,27,2
11/13/2020,250,243,7,7,3,12,10,7
